XXXXXXXXXXXXXXXXXXXXXXXXXXXXXXXXXXXXXXXXXXXXXXXXXXXXXXXXXXXXXXXX
XXX                                                          XXX
X                                                              X
X                                                              X
X                                                              X
X                                                              X
X                                                              X
X                                                              X
X                                                              X
X                                                              X
X                                                              X
X                                                              X
X                                                              X
X                                                              X
X                           XXXXXXXX                           X
XXXXXXX                     XXXXXXXX                     XXXXXXX
X                           XXXXXXXX                           X
X                                                              X
X                                                              X
X                                                              X
X                                                              X
X                                                              X
X                                                              X
X                                                              X
X                                                              X
X                                                              X
X                                                              X
X                                                              X
X                                                              X
X                                                              X
XXX                                                          XXX
XXXXXXXXXXXXXXXXXXXXXXXXXXXXXXXXXXXXXXXXXXXXXXXXXXXXXXXXXXXXXXXX
