XXXXXXXXXXXXXXXXXXXXXXXXXXXXXXXXXXXXXXXXXXXXXXXXXXXXXXXXXXXXXXXX
XX                                                            XX
X                                                              X
X                                                              X
X                                                              X
X                                                              X
X                               X                              X
X                               X                              X
X                               X                              X
X                               X                              X
X                               X                              X
X                               X                              X
X                               X                              X
X                           XXXXXXXXX                          X
X                           XXXXXXXXX                          X
X                    XXXXXXXXXXXXXXXXXXXXXXX                   X
X                           XXXXXXXXX                          X
X                           XXXXXXXXX                          X
X                               X                              X
X                               X                              X
X                               X                              X
X                               X                              X
X                               X                              X
X                               X                              X
X                               X                              X
X                                                              X
X                                                              X
X                                                              X
X                                                              X
X                                                              X
XX                                                            XX
XXXXXXXXXXXXXXXXXXXXXXXXXXXXXXXXXXXXXXXXXXXXXXXXXXXXXXXXXXXXXXXX
